+++++ ----- Skills ----- +++++

++++ ----- Combat Skills ----- ++++
sr:"(.*?) Lv.(\d+)"=$1 Lv.$2
sr:"(.*?) <color\=#0F69CB>Lv.(\d+)</color>"=$1 <color\=#0F69CB>Lv.$2</color>
전투 기술=Combat Arts
멍청한 조수=Foolish Sidekick 
똑똑한 탐험가=Smart Explorer
왕성한 동심=Vigorous Innocence
의문 추적=Tracing Doubts
복수=Revenge
액운의 추격=Chasing Misfortune
불길한 징조=Ominous Signs
자신=Self-Confidence
미라클 펀치=Miracle Punch
치유술=Healing Art
질풍 강습=Tempest Raid
예민한 후각=Keen Sense of Smell
정열=Passion
활력=Vitality
화끈한 변주곡=Fiery Variations
화려한 흔들림=Splendid Shaking
즐거운 파티=Joyful Party
속성 증가=Attribute Increase
건방진♪댄스=Cheeky♪Dance
특공=Special Attack
차지 일격=Charged Blow
전격의 징계=Thunderbolt Punishment
폭발 충돌=Explosive Collision
위로=Consolation
화염의 침식=Flame Erosion
매화술=Plum Blossom Technique
만발한 꽃=Blooming Flowers
매력 육성=Charm Nurturing
희망=Hope
광명=Brightness
엔젤의 연민=Angel's Compassion
타오르는 불길=Burning Flames
소리 없는 기습=Silent Ambush
수호=Protection
힘=Strength
전기 상어=Electric Shark
초고속 전격=Ultra High-Speed Lightning
천둥의 격노=Thunder's Fury
진격의 나팔=Trumpet of Advance
무경=Thoughtless
무아=No-Self
차가운 칼날=Cold Blade
공중의 나선=Aerial Spiral
동경=Longing
얽매임=Entanglement
여명의 거품=Foam of Dawn
묶인 자=The Bound One
추적=Tracking
환상=Fantasy
굿나잇 송=Goodnight Song
풀피리 찬가=Reed Flute Hymn
염의 선율=Melody of Thought
풀빛의 호흡=Breath of Grass
주언=Incantation
조종=Manipulation
낭만적인 정극=Romantic Drama
허황된 희극=Absurd Comedy
애통한 비극=Sorrowful Tragedy
동행=Accompany
항쟁=Struggle
에너지 변환=Energy Conversion
생명 추출=Life Extraction
핵열의 환상=Nuclear Heat Illusion
도시 감시자=City Watcher
가드 수비=Guard Defense
모략=Conspiracy
야만=Barbarism
흔들리는 빙산=Shaking Iceberg
신적=Divine
은혜=Grace
폭염=Heat Wave
헌제의 결심=Determination of Offering
혁지=Correction
동정심=Compassion
절대 심판=Absolute Judgment
올바른 명령=Righteous Command
법의 관례=Legal Precedent
만발=Full Bloom
웃음소리=Laughter
사자놀이=Lion Play
피안의 덤불=Underworld Thicket
나룻배 사공=Ferry Boatman
유유한 망천수=Leisurely Oblivion
##### Persona Combat Skills
부흐=Bufu
부후라=Bufula
부후다인=Bufudyne
마하부후=Mabufu
마하부흐=Mabufu
마하부후라=Mabufula
마하부후다인=Mabufudyne
마하부흐다인=Mabufudyne
다이아몬드 더스트=Diamond Dust
아기=Agi
아기라오=Agilao
아기다인=Agidyne
마하라기=Maragi
마하라기온=Maragion
마하라기다인=Maragidyne
인페르노=Inferno
티타노마키아=Titanomachia
지오=Zio
지온가=Zionga
지오다인=Ziodyne
마하지오=Mazio
마하지온가=Mazionga
마하지오다인=Maziodyne
갈=Garu
갈라=Garula
갈다인=Garudyne
마하갈=Magaru
마하갈라=Magarula
마하갈다인=Magarudyne
진공파=Vacuum Wave
사이=Psi
사이오=Psio
사이다인=Psiodyne
마하사이=Mapsi
마하사이오=Mapsio
마하사이다인=Mapsiodyne
사이코포스=Psycho Force
프레이=Frei
프레이라=Freila
프레이다인=Freidyne
아토믹 플레어=Atomic Flare
마하프레이=Mafrei
마하프레이라=Mafreila
마하프레이다인=Mafreidyne
코즈믹 플레어=Cosmic Flare
타루카자=Tarukaja
라쿠카자=Rakukaja
스쿠카자=Sukukaja
마하타루카=Matarukaja
마하라쿠카자=Marakukaja
마하스쿠카자=Masukukaja
하마=Hama
하마온=Hamaon
마한마=Mahama
마한마온=Mahamaon
코우하=Kouha
코우가=Kouga
코우가온=Kougaon
마하코우하=Makouha
마하코우가=Makouga
마하코우가온=Makougaon
에이하=Eiha
무드=Mudo
마하무드=Mamudo
무드온=Mudoon
마하무드온=Mamudoon
메기도=Megido
메기도라=Megidola
메기도라온=Megidolaon
메기도라다인=Megidoladyne
디아=Dia
디아라마=Diarama
디아라한=Diarahan
메디아=Media
메디라마=Mediarama
메디아라한=Mediarahan
오라토리오=Oratorio
메시아라이저=Salvation
카덴차=Cadenza
리캄=Recarm
사마리캄=Samarecarm
리캄드라=Recarmdra
방전의 벽=Elec Wall
이연아=Giant Slice


++++ ----- Common Combat Phrases ----- ++++
전투 설정=Battle Settings
방어=Defense
근접 공격=Melee Attacks
페르소나 전환=Switching Personas
페르소나=Personas
총기=Firearms
총공격=All-Out-Attack
서포트=Support
자동 전투=Auto-Battle
가속=Fast-Forward
감전=Electric Shock
스킬 효과=Skill Effects
상태 정보=Status Information
공격력 감소=Attack Reduction
총격 단일= Single-Target Shot
특공=Special Attacks
크리티컬 확률=Critical Rate
크리티컬 효과=Critical Damage
SP 회복=SP Recovery Bonus
효과 명중=Effect Hit Rate Bonus
효과 저항=Effect Resist Bonus
치료 효과=Outgoing Healing Bonus
받는 치료 효과=Incoming Healing Bonus
실드 효과=Outgoing Shield Bonus
받는 실드 효과=Incoming Shield Bonus
물리 대미지=Phys Damage
총격 대미지=Gun Damage
화염 대미지=Fire Damage
빙결 대미지=Ice Damage
전격 대미지=Electric Damage
질풍 대미지=Wind Damage
염동 대미지=Psychokinesis Damage
핵열 대미지=Nuclear Damage
축복 대미지=Bless Damage
주원 대미지=Curse Damage
만능 대미지=Almighty Damage
총알 수: =Bullet Count: 
기본 크리티컬 확률: =Base Critical Chance: 
공격력=ATK
생명=HP
방어력=DEF
속도=SPD
페르소나 레벨=Persona levels

++++ ----- Persona Passive Skills ----- ++++
명중 강화Ⅰ=Accuracy Boost I
효과 명중이 7% 증가한다.=Effect Hit Rate increased by 7%.
민첩의 마음가짐Ⅰ=Agile Mindset I
속도가 6포인트 증가한다.=SPD increased by 6.
공격 강화Ⅰ=Attack Boost I
공격력이 5.8% 증가한다.=ATK increased by 5.8%.
승리의 숨결Ⅰ=Breath of Victory I
전투 승리 후 최대 생명과 SP를 2.5% 회복한다.=2.5% of Max HP and SP restored after winning a battle.
방어 강화Ⅰ=Defense Boost I
방어력이 8.8% 증가한다.=DEF increased by 8.8%.
전격 강화Ⅰ=Elec Boost I
전격 속성 대미지가 4.7% 증가한다.=Electric Damage increased by 4.7%.
화염 강화Ⅰ=Fire Boost I
화염 속성 대미지가 4.7% 증가한다.=Fire Damage increased by 4.7%.
굳건한 산Ⅰ=Firm Mountain I
속도가 6포인트 감소하고, 생명이 15% 증가한다.=SPD reduced by 6, HP increased by 15%.
우중충한 하늘Ⅰ=Gloomy Sky I
비가 내릴 때 이상 효과 부여 시 효과 명중이 9.1% 증가한다.=Effect Hit Rate increased by 9.1% when it's raining.
정밀한 사격Ⅰ=Gun Boost I
총기 대미지가 4.7% 증가한다.=Gun Damage increased by 4.7%.
치료 강화Ⅰ=Healing Boost I
주는 치료 효과가 4.2% 증가한다.=Outgoing Healing increased by 4.2%.
빙결 강화Ⅰ=Ice Boost I
빙결 속성 대미지가 4.7% 증가한다.=Ice Damage increased by 4.7%.
생명 강화Ⅰ=Life Boost I
생명이 5.1% 증가한다.=HP increased by 5.1%.
마도의 재능Ⅰ=Magic Ability I
주는 대미지가 4.7% 증가한다.=Damage increased by 4.7%.
마술의 소양Ⅰ=Magic Knowledge I
스킬 사용 시 소모하는 SP가 2.4% 감소한다.=Skill SP cost decreased by 2.4%.
무도의 마음가짐Ⅰ=Martial Arts Mindset I
스킬 사용 시 소모하는 HP가 3.2% 감소한다.=Skill HP cost decreased by 3.2%.
핵열 강화Ⅰ=Nuclear Boost I
핵열 속성 대미지가 4.7% 증가한다.=Nuclear Damage increased by 4.7%.
기공Ⅰ=Pore I
SP 회복 효율이 3.1% 증가한다.=SP Recovery Boost increased by 3.1%.
정교한 타격Ⅰ=Precise Blow I
크리티컬 효과가 7% 증가한다.=Critical Damage increased by 7%.
건언Ⅰ=Proclamation I
크리티컬 확률이 3.5% 증가한다.=Critical Rate increased by 3.5%.
비의 노래Ⅰ=Rain Song I
비가 올 시 받는 대미지가 6.1% 감소한다.=Damage taken reduced by 6.1% when it's raining.
치료 촉진Ⅰ=Regenerate I
턴 시작 시 최대 생명 1.9%를 회복한다.=1.9% of Max HP restored at the start of each turn.
축복 간파Ⅰ=Resist Bless I
받는 축복 속성 대미지가 4.7% 감소한다.=Damage from Bless attacks reduced by 4.7%.
전격 간파Ⅰ=Resist Elec I
받는 전격 속성 대미지가 4.7% 감소한다.=Damage from Electric attacks reduced by 4.7%.
핵열 간파Ⅰ=Resist Nuclear I
받는 핵열 속성 대미지가 4.7% 감소한다.=Damage from Nuclear attacks reduced by 4.7%.
질풍 간파Ⅰ=Resist Wind I
받는 질풍 속성 대미지가 4.7% 감소한다.=Damage from Wind attacks reduced by 4.7%.
질풍 강화Ⅰ=Wind Boost I
질풍 속성 대미지가 4.7% 증가한다.=Wind Damage increased by 4.7%.

+++ ----- Unsorted Skills ----- +++
불렛 타임=Bullet Time
흑백무계=Monochrome
궁지 반격=Counterattack
피어나는 얼음=Blooming Ice
차가운 칼날=Cold Blade
매서운 겨울=Bitter Winter
초고속 전격=Lightning Blitz
천둥의 격노=Thunderous Wrath
희망의 빔=Ray of Hope
금강발파=Diamond Blast
빅 슬라이스=Giant Slice
여명의 거품 Lv.2=Bubble of Dawn Lv.2
동정심 Lv.1=Compassion Lv.1
절대 심판 Lv.1=Absolute Judgment Lv.1
올바른 명령 Lv.1=Direct Commands Lv.1
대의자의 판결 Lv.1=Judgment of the Great One Lv.1
우아한 풍파 Lv.1=Elegant Wind Waves Lv.1
바람의 속삭임 Lv.1=Whisper of the Wind Lv.1
치유술 Lv.1=Healing Arts Lv.1
질풍 강습 Lv.1=Windstorm Assault Lv.1
질풍 강습=Gale Strike
0도 치유=Healing Circle
선봉 돌격=Spearhead Assault
흔들리는 빙산=Shattering Iceberg
용감한 자의 게임=Game of the Brave
즐거운 파티=Party Time
차지 일격=Charge Strike
전격의 징계=Electric Punishment
폭발 충돌=Explosive Collision
오장폭발권=Five Finger Explosion
r:"준비 시간: 행동 8회\n모든 동료가 <color\=#FFFC40>(\d+)</color>의 SP를 회복한다. <link\=\"s|141\"><u>『리듬』</u></link>을 3개 획득한다.\n<b><size\=28><color\=#850101>스포트라이트 아래서 리듬을 타지 않을 사람은 아무도 없다. 멜로디에 몸을 맡기고 박자에 맞춰 음악의 매력을 마음껏 느껴보자!</color></size></b>"=Prep Time: Act 8\nAll party members restore <color\=#FFFC40>$1</color> SP, and Okyann obtains 3 stacks of <link\=s|141><u>Rhythm</u></link>.\n<b><size\=28><color\=#850101>There's no one who wouldn't get into the rhythm under a spotlight. Give yourself up to the melody and feel the beat!</color></size></b>
r:"적 <color\=#FFFF00>1명</color>에게 공격력 (\d+\.\d+%)의 총격 속성 대미지를 주고, 75%의 고정 확률로 적이 『조준』을 획득한다."=Deals $1 Gun damage to <color\=#FFFF00>1</color> Enemy, with a 75% fixed chance to Target the enemy.
r:"<color\=#FFFF00>모든</color> 적에게 공격력 (\d+\.\d+%)의 축복 속성 대미지를 주고, 생명이 가장 낮은 동료가 공격 (\d+\.\d+%)의 생명을 회복한다."=Deals $1 ATK Bless damage to <color\=#FFFF00>all</color> enemies, and heals the lowest Health ally for $2 of ATK.
r:"<color\=#FFFF00>모든</color> 적에게 공격력 (\d+\.\d+%)의 3단 총격 속성 대미지를 준다. 필드에 조준당한 적이 있을 시 해당 스킬의 공격력이 (\d+\.\d+%) 증가하고, 크리티컬 효과가 (\d+\.\d+%) 증가한다."=Deals 3x $1 ATK Gun damage to <color\=#FFFF00>all</color> enemies, with $2 more damage and $3 more Critical Damage when Targeted enemies are on the field.
r:"<color\=#FFFF00>모든</color> 적에게 공격력 (\d+\.\d+%)의 주원 속성 대미지를 준다. (\d+%)의 기본 확률로 적이 주원 효과를 1중첩 획득하고, 『살기』를 (\d)개 획득한다."=Deals $1 ATK Elemental damage to <color\=#FFFF00>all</color> enemies with a $2 base chance to grant the enemy a stack of Elemental effects and gain $3 Life.
r:"적 <color\=#FFFF00>1명</color>에게 공격력 (\d+\.\d+%)의 주원 속성 대미지를 준다. 필드에 적이 <color\=#FFFF00>1명</color>만 있을 시 『살기』를 (\d)개 획득한다."=Deals $1 ATK Elemental damage to <color\=#FFFF00>1</color> enemy. If there is <color\=#FFFF00>1</color> enemy on the field, gain $2 Life.
r:"<color\=#FFFF00>모든</color> 적에게 공격력 (\d+\.\d+%)의 주원 속성 대미지를 준다. 적에게 디버프 효과가 있을 시 주는 대미지가 (\d+%) 증가하고, 추가 턴에서는 해당 효과가 (\d+%)까지 증가한다."=Deals $1 ATK Elemental damage to <color\=#FFFF00>all</color> enemies. Increases the damage dealt by $2 if the enemy is debuffed, and increases the effect to $3 for additional turns.
r:"적 <color\=#FFFF00>1명</color>에게 공격력 (\d+\.\d+%)의 질풍 대미지를 주고, (\d+%)의 기본 확률로 적을 풍습 상태로 만든다."=Deals $1 ATK Wind damage to <color\=#FFFF00>1</color> enemy with a 100% base chance to inflict Weaken.
r:"<color\=#FFFF00>모든</color> 동료의 공격력 (\d+\.\d+%)\+생명 (\d+)를 회복시키고, 모든 동료의 원소 이상 상태 1개를 제거한다."=Heals <color\=#FFFF00>all</color> allies for HP equal to $1 ATK + $2 and removes 1 Elemental Ailment from all allies.
r:"적 <color\=#FFFF00>1명</color>에게 공격력 (\d+\.\d+%)의 물리 대미지를 주고, 크리티컬 확률이 (\d+%) 증가하며 명중률이 (\d+%) 감소한다."=Deals $1 ATK Physical damage to <color\=#FFFF00>1</color> enemy. Critical rate increases by $2, but hit rate decreases by $3.
r:"<color\=#FFFF00>임의의</color> 적에게 공격력 (\d+\.\d+%)의 (\d+)단 전격 속성 대미지를 주고, 100%의 기본 확률로 메인 목표를 감전 상태에 빠뜨린다."=Deals $2x $1 ATK Electric damage to <color\=#FFFF00>random</color> enemies, with a 100% chance to Shock the primary target.
r:"<color\=#FFFF00>1명</color>의 적에게 공격력 (\d+\.\d+%)의 전격 속성 대미지를 주고, (\d+)턴 동안 모든 동료가 주는 전격 속성 대미지를 (\d+\.\d+%) 증가시킨다."=Deals $1 ATK Electric damage to <color\=#FFFF00>1</color> enemy, and increases Electric damage from all teammates by $3 for $2 turns.
r:"<color\=#FFFF00>모든</color> 적에게 공격력 (\d+\.\d+%)의 전격 속성 대미지를 준다. 임의의 적이 감전 상태인 경우 <color\=#FFFF00>모든</color> 적에게 공격력 (\d+\.\d+%)에 해당하는 추가 대미지를 준다."=Deals $1 ATK Electric damage to <color\=#FFFF00>all</color> enemies. If any enemy is Shocked, deals an additional $2 ATK damage to <color\=#FFFF00>all</color> enemies.
r:"적 <color\=#FFFF00>1명</color>에게 공격력 (\d+\.\d+%)의 화염 속성 대미지를 주고, (\d+%)의 기본 확률로 적을 화상 상태로 만든다."=Deal $1 ATK Fire damage to <color\=#FFFF00>1</color> enemy with a $2 chance to inflict Burn.
r:"동료 <color\=#FFFF00>1명</color>의 공격력 (\d+\.\d+%)\+생명 (\d+)를 회복시킨다. 동료의 생명이 (\d+%) 미만이면 치료 효과가 (\d+%) 증가한다."=Heals <color\=#FFFF00>1</color> ally for HP equal to $1 ATK + $2. If the ally's HP is less than $3, healing increases by $4.
r:"<color\=#FFFF00>모든</color> 동료의 공격력 %\+(\d+\.\d+%)의 생명을 회복하고, 메인 목표 동료에게 주는 치료 효과가 (\d+) 증가한다."=Heals <color\=#FFFF00>all</color> allies for HP equal to $1 ATK and increases the healing to the primary target ally by $2.
r:"적 <color\=#FFFF00>1명</color>에게 공격력 (\d+\.\d+%)의 물리 속성 대미지를 (\d+)회 주고, 자신의 생명이 (\d+%) 초과 시 해당 스킬은 생명 (\d+%)를 추가 소모하고 대미지가 (\d+%) 증가한다."=Deals $2x $1 ATK Physical damage to <color\=#FFFF00>1</color> enemy. If your HP is over $3, this skill consumes an additional $4 HP and increases damage dealt by $5.
r:"<color\=#FFFF00>모든</color> 적에게 공격력 (\d+\.\d+%)의 전격 대미지를 주고, (\d+\.\d+%)의 기본 확률로 적을 감전 상태에 빠뜨린다. 『리바운드』가 있을 경우 확률이 (\d+\.\d+%)까지 증가한다."=Deals $1 ATK Electric damage to <color\=#FFFF00>all</color> enemies with a $2 base probability to inflict Shock. If Rebound is applied, this probability increases to $3.
r:"적 <color\=#FFFF00>1명</color>을 선택해 차지한 후 다음 턴에서 공격 시 공격력 (\d+\.\d+%)의 물리 속성 대미지를 준다. 대미지를 입힐 시 자신이 『리바운드』 효과가 있으면 해당 스킬은 무조건 크리티컬이 발동한다."=Waits, then deals $1 ATK Physical damage to <color\=#FFFF00>1</color> enemy on the following turn. If Rebound is applied, this skill will always deal Critical damage.

++++ ----- Battle Quotes ----- ++++
좋은~ 기회야! 다들 놈을 해치워~!=This is your chance! Everybody, take them out!
지금부터 나를 잘 보고 있어!=Keep an eye on me from now on!
이야~! 신~난~다!=Yay! This is so exciting!
총알이 부족합니다.=You're out of bullets.
오! 정말 강력한 일격이었어!=Oh! What a powerful blow!
역시 오빠야~!=That's my onii-sama~!
내가 있잖아. 이건 당연한 결과야~!=With me here, victory is a given~!
오빠, 나 준비됐어!=Onii-sama, I'm ready to go!
오빠, 엄청 강하다~!=Onii-sama, you're so strong~!
힘을 내! 너 괜찮아? ?=Come on! Are you okay?
후... 괜찮다니 다행이다.=Phew... glad to hear you're okay.
만세! 적이 쓰러졌어!=Hooray! The enemies are down!
공연의 하이라이트다!=And here comes the highlight!
큰일이야! 괜찮지? ?=This looks bad! Are you okay?
와... 순식간에 쓰러졌어...=Wow... It went down in a flash...
전력을 다하자!=Let's go all out!
대단해~!=That was amazing!
오, 좋은데. 엄청 귀한 걸 얻었어!=How wonderful! This looks valuable!
정신 차리고 탐색을 시작하자...=Let us go and explore further.
클로저는 이제 괜찮아=Closer seems fine now.
하지만, 예고하기 전에\n너희들에게 확인하고 싶은 것이 있다.=However, before we move on, I want to confirm something with you guys.
화려하게 가자=Let's go out in a big way!
…헉?! 내가?=...Huh?! Me?

++++ ----- Field/Mementos Quotes ----- ++++
근처에 좋은 게 있는 것 같아.\n찾아보자!=I think there's something good nearby, let's find it!
그래. 맞지 않도록 조심하며\n앞으로 나아가자.=Okay, let's move forward, while being careful to not get hit.
아, 세이프 룸이야.\n쉴까?=Ah, a safe room.\nShould we take a break?
가져갈까?=Should we take it?
오빠, 난 언제든 나설 수 있어!=Onii-sama, I'm always ready to go!
상자야. 어서 열어보자!=It's a treasure chest. Let us open it!

+++++ ----- Combat Information ----- +++++
1턴=1 Turn
r:"^(\d+)턴$"=$1 Turns
sr:"<color\=#FF0000>(.*?)</color>이\(가\) 야노식에게 조준되어 방어력이 감소합니다..."=<color\=#FF0000>$1</color> has been targeted by Janosik, reducing its defense...
sr:"<color\=#FF0000>(.*?)</color>이\(가\) 다운 상태에서 회복되었습니다."=<color\=#FF0000>$1</color> recovered from being Downed.
