+++++ ----- Names ----- +++++

++++ ----- Characters ----- ++++
메로페=Merope
이고르=Igor
원더=Wonder
캐틀=Cattle
루페르=Lufel
클로저=Closer
아라이 모토하=Motoha Arai
소이=Soy
카노 슌=Shun Kanou
윈드=Wind
타네무라 리코=Riko Tanemura
키=Key
쿠로타니 키요시=Kiyoshi Kurotani
몬트=Mont
코토네 몽타뉴=Kotone Montagne
부이=BUI
플뢰레=Fleuret
시라토리 세이지=Seiji Shiratori
모코=Moko
노게 토모코=Tomoko Noge
리들=Riddle
니시모리 하루나=Hina Nishimori
레온=Leon
카미야마 레오=Reo Kamiyama
유키=Yuki
후지카와 유키미=Yukimi Fujikawa
린=Rin
리 야오링=Yaoling Li
세피아=Sepia
스미 토시야=Toshiya Sumi
오캔=Okyann
토미야마 카요=Kayo Tomiyama
퍼핏=Puppet
사하라 미유=Miyu Sahara
마루치무=Marthym
카타야마 쿠미=Kumi Katayama
카게야마 에나=Ena Kageyama
타케미 타에=Tae Takemi
사쿠라 소지로=Sojiro Sakura
소지로=Sojiro
요시다 토라노스케=Toranosuke Yoshida
이와이 무네히사=Munehisa Iwai
이와이=Iwai
하나사키 메구미=Megumi Hanasaki
나나미=Nanami
미후네 치하야=Chihaya Mifune
미후네=Mifune
오다 신야=Shinya Oda
아케치 고로=Goro Akechi
아케치=Akechi
니지마 사에=Sae Niijima
사카모토 류지=Ryuji Sakamoto
류지=Ryuji
스컬=Skull
조커=Joker
팬서=Panther
타카마키 안=Ann Takamaki
모르가나=Morgana
모나=Mona
키타가와 유스케=Yusuke Kitagawa
유스케=Yusuke
폭스=Fox
니지마 마코토=Makoto Niijima
마코토=Makoto
퀸=Queen
내비=Oracle
사쿠라 후타바=Futaba Sakura
후타바=Futaba
오쿠무라 하루=Haru Okamura
하루=Haru
누아르=Noir
크로우=Crow
바이올렛=Violet
요시자와 카스미=Kasumi Yoshizawa
하세가와 젠키치=Zenkichi Hasegawa
울프=Wolf
소피아=Sophia
소피=Sophie
카모시다 스구루=Suguru Kamoshida
카모시다=Kamoshida
마다라메 이치류사이=Ichiryusai Madarame
마다라메=Madarame
카네시로 쥰야=Junya Kaneshiro
카네시로=Kaneshiro
오쿠무라 쿠니카즈=Kunikazu Okumura
오쿠무라=Okumura
시도 마사요시=Masayoshi Shido
시도=Shido
섀도=Shadow
도겐자카 루우나=Runa Dogenzaka
타네무라 리코·매화=Riko Tanemura: Plum
타네무라 리코=Riko Tanemura
리 야오링·사자무=Li Yaoling: Lion Dance
아라이 모토하·여름=Arai Motoha: Summer
아라이 모토하=Arai Motoha
코토네 몽타뉴·백조=Kotone Montagne: New Swan
코토네 몽타뉴=Kotone Montagne
시이나 유우미=Yumi Shiina
나가오 치즈코=Chizuko Nagao
카미야마 레오=Reo Kamiyama
++++ ----- Personas ----- ++++
잭 오 랜턴=Jack o' Lantern
픽시=Pixie
바이콘=Bicorn
맨드레이크=Mandrake
인큐버스=Incubus
서큐버스=Sucubus
엔젤=Angel
아르센=Arsène
하이픽시=High Pixie
이자나기=Izanagi
이자나기 피카로=Izanagi Picaro
오르페우스=Orpheus
오르페우스 피카로=Orpheus Picaro
피카로=Picaro
데카라비아=Decarabia
레기온=Legion
오세=Ose
디오니소스=Dionysus
사악한 프로스트=Black Frost
비슈누=Vishnu
사타나엘=Satanael
조로=Zorro
잭 프로스트=Jack Frost
네코마타=Nekomata
샌드맨=Sandman
퀸 메이브=Queen Mab
랑다=Rangda
수르트=Surt
후츠누시=Futsunushi
실키=Silky
아프사라스=Apsaras
요한나=Johanna
키쿠리히메=Kikuri-Hime
스카아하=Scathach
사라스바티=Sarasvati
스카디=Skadi
키벨레=Cybele
야크시니=Yaksini
라미아=Lamia
밀라디=Milady
하리티=Hariti
다키니=Dakini
티타니아=Titania
칼리=Kali
마더 할롯=Mother Harlot
고에몬=Goemon
엘리고르=Eligor
세탄타=Setanta
토트=Thoth
오오쿠니누시=Okuninushi
바롱=Barong
킹 프로스트=King Frost
오베론=Oberon
바알=Baal
오딘=Odin
베리스=Berith
오로바스=Orobas
봉황=Feng Huang
안즈=Anzu
유니콘=Unicorn
대승정=Daisoujou
포르네우스=Forneus
비사문천=Bishamonten
황룡=Kohryu
카르멘=Carmen
사키미타마=Saki Mitama
랴난시=Leanan Sidhe
아메노우즈메=Ame-no-Uzume
쿠시나다히메=Kushinada-Hime
나르키소스=Narcissus
파르바티=Parvati
라파엘=Raphael
이슈타르=Ishtar
아가시온=Agathion
캡틴 키드=Captain Kidd
슬라임=Slime
시사=Shiisaa
시키오우지=Shiki-Ouji
킨키=Kin-Ki
아라미타마=Ara Mitama
화이트 라이더=White Rider
케르베로스=Cerberus
토르=Thor
치우=Chi You
아크엔젤=Archangel
프린시펄리티=Principality
파워=Power
로빈 후드=Robin Hood
멜키세덱=Melchizedek
도미니온=Dominion
트론=Throne
우리엘=Uriel
메타트론=Metatron
코로포클=Koropokkur
잇폰다타라=Ippon-Datara
스다마=Sudama
나가=Naga
네크로노미콘=Necronomicon
아라하바키=Arahabaki
쿠반다=Kumbhanda
광목천=Koumokuten
쿠라마텐구=Kurama Tengu
온교우키=Ongyo-Ki
클로토=Clotho
아리아드네=Ariadne
라케시스=Lachesis
아트로포스=Atropos
포르투나=Fortuna
노른=Norn
아스테리오스=Asterius
아스테리오스 피카로=Asterius Picaro
락슈미=Lakshmi
켈피=Kelpie
쿠시미타마=Kushi Mitama
오니=Oni
락샤사=Rakshasa
증장천=Zouchouten
발키리=Valkyrie
지크프리트=Siegfried
자오우곤겐=Zaou-Gongen
화백=Hua Po
이누가미=Inugami
오르트로스=Orthrus
타케미나카타=Take-Minakata
헤카톤케일=Hecatoncheires
몰렉=Moloch
바스키=Vasuki
아티스=Attis
모코이=Mokoi
마타도르=Matador
피샤차=Pisaca
헬즈 엔젤=Hell Biker
페일 라이더=Pale Rider
체르노보그=Chernobog
타나토스=Thanatos
모트=Mot
앨리스=Alice
현무=Genbu
콥파텐구=Koppa Tengu
콧파텐구=Koppa Tengu
마카미=Makami
니기미타마=Nigi Mitama
지국천=Jikokuten
미트라=Mithra
백호=Byakko
나가라자=Raja Naga
청룡=Seiryu
가브리엘=Gabriel
알더=Ardha
안드라스=Andras
플라로우스=Flauros
릴림=Lilim
파즈스=Pazuzu
바포멧=Baphomet
네비로스=Nebiros
벨리알=Belial
베엘제붑=Beelzebub
바알세불=Baal Zebul
자타유=Jatayu
벨페고르=Belphegor
레드라이더=Red Rider
마가츠 이자나기=Magatsu-Izanagi
마가츠 이자나기 피카로=Magatsu-Izanagi Picaro
세트=Seth
블랙라이더=Black Rider
마라=Mara
요시츠네=Yoshitsune
마다=Mada
코다마=Kodama
후우키=Fuu-Ki
네코쇼군=Neko Shogun
케완=Kaiwan
아난타=Ananta
가루다=Garuda
하누만=Hanuman
쿠 훌린=Cu Chulainn
스라오샤=Sraosha
루시퍼=Lucifer
루시펠=Lucifer
온모라키=Onmoraki
카구야=Kaguya
누에=Nue
스이키=Sui-Ki
카구야=Kaguya
카구야 피카로=Kaguya Picaro
블랙 우즈=Black Ooze
모스맨=Mothman
기리메칼라=Girimehkala
츠키요미=Tsukiyomi
츠키요미 피카로=Tsukiyomi Picaro
릴리스=Lilith
산달폰=Sandalphon
주작=Suzaku
미트라스=Mithras
유룽=Yurlungur
호루스=Horus
가네샤=Ganesha
야타가라스=Yatagarasu
케찰코아틀=Quetzalcoatl
아수라왕=Asura-Ou
아누비스=Anubis
트럼페터=Trumpeter
야마타노오로치=Yamata-no-Orochi
아바돈=Abaddon
메사이어=Messiah
메사이어 피카로=Messiah Picaro
시바=Shiva
미카엘=Michael
사탄=Satan
프로심나=Prosymna
스틱스=Styx
로브로이=Rob Roy
테르프시코레=Terpsichore
야노식=Janosik
슈케=Syke
아르빌다=Awilda
네메르테스=Nemertes
맹파=Meng Po
고르귀라=Gorgyra
클레오도라=Cleodora
에리테이아=Eritheia
다에이라=Daeira
레우코테아=Leucothea
만돌란=Mandrin


++++ ----- CV's ----- ++++
CV.우치야마 코우키=CV. Koki Uchiyama
CV.혼도 카에데=CV. Kaede Hondo
CV.시모지 시노=CV. Shino Shimoji
CV.코바야시 유스케=CV. Yuusuke Kobayashi
CV.아케사카 사토미=CV. Satomi Akesaka
CV.이치노세 카나=CV. Kana Ichinose
CV.미즈키 나나=CV. Nana Mizuki
CV.타나카 아츠코=CV. Atsuko Tanaka
CV.미야노 마모루=CV. Mamoru Miyano
CV.노나카 아이=CV. Ai Nonaka
CV.스와 아야카=CV. Ayaka Suwa
CV.토요나가 토시유키=CV. Toshiyuki Toyonaga
CV.이세 마리야=CV. Mariya Ise
CV.코니시 카츠유키=CV. Katsuyuki Konishi
CV.에노키 준야=CV. Junya Enoki
CV.루팅=CV. Ru Thing
CV.오구라 유이=CV. Yui Ogura
CV.후쿠야마 쥰=CV. Jun Fukuyama
CV.오오타니 이쿠에=CV. Ikue Otani
CV.우치야마 코우키=CV. Kouki Uchiyama
CV.혼도 카에데=CV. Kaede Hondo
CV.코바야시 유스케=CV. Yusuke Kobayashi
CV.이치노세 카나=CV. Kana Ichinose
CV.토요나가 토시유키=CV. Toshiyuki Toyonaga
CV.시모지 시노=CV. Shino Shimoji
CV.루팅=CV. Ru Thing
CV.오오타니 이쿠에=CV. Ikue Ohtani
CV.미즈키 나나=CV. Nana Mizuki
CV.노나카 아이=CV. Nonaka Ai
CV.아케사카 사토미=CV. Satomi Akesaka
CV.에노키 준야=CV. Junya Enoki
CV.스와 아야카=CV. Suwa Ayaka
CV.코니시 카츠유키=CV. Katsuyuki Konishi
CV.타나카 아츠코=CV. Atsuko Tanaka
CV.이세 마리야=CV. Mariya Ise
CV.오구라 유이=CV. Yui Ogura
CV.후쿠야마 쥰=CV. Jun Fukuyama
CV.미야노 마모루=CV. Mamoru Miyano
++++ ----- Other ----- ++++
