++++ ----- Phantom Thief Combat Skills ----- ++++
Yuki Makoto

테우르기아 에너지=Theurgy Energy
테우르기아=Theurgy


++++ ----- Locations ----- ++++
이와토다이=Iwatodai
폴로니안 몰=Paulownia Mall

++++ ----- Terms ----- ++++
섀도 타임=Dark Hour
타르타로스=Tartarus
특별과외활동부=Specialized Extracurricular Execution Squad
박명의 파편=Twilight Fragments
새벽의 파편=Dawn Fragments
큰 시계=Great Clock
심령 조각=Heart Fragments
시간의 톱니바퀴=Clock Gears
오래된 금화=Ancient Gold Coins
오래된 은화=Ancient Silver Coins


++++ ----- Character names ----- ++++
유키 마코토=Makoto Yuki
유키 군=Yuki-kun
유키=Yuki
이오리 준페이=Junpei Iori
타케바 유카리=Yukari Takeba
유카리=Yukari
키리조 미츠루=Mitsuru Kirijo
사나다 아키히코=Akihiko Sanada
아라가키 신지로=Shinjiro Aragaki
코로마루=Koromaru
아마다 켄=Ken Amada
야마기시 후카=Fuuka Yamagishi 
아이기스=Aigis

나가오 치즈코=Chizuko Nagao
카미야마 레오=Reo Kamiyama
사하라 미유=Miyu Sahara