-------------------
Story Terms
------------------
毀滅=Ruin
风纪委员长=Head of Disciplinary Committee
磨我痛神=Magatsushin
影时间=Dark Hour
特别课外活动部=SEES
神通法=Theurgy
塔尔塔罗斯=Tartarus
怪盗家族=Phantom Thieves Familia
怪盗=Phantom Thief

----------------------------
Character Names
----------------------------

----------------------------
P3R
----------------------------
结城同学=Yuki-kun
结城理=Makoto Yuki
结城 理=Makoto Yuki
结城=Yuki
汐见琴音=Kotone Shiomi
汐见=Shiomi
岳羽 由加莉=Yukari Takeba
岳羽由加莉=Yukari Takeba
岳羽=Takeba
由加莉=Yukari
伊织顺平=Junpei Iori
伊织=Iori
顺平=Junpei
桐条美鹤=Mitsuru Kirijo
桐条前辈=Kirijo-senpai
桐条=Kirijo
美鹤=Mitsuru
真田明彦=Akihiko Sanada
真田前辈=Sanada-senpai
真田=Sanada
明彦=Akihiko
山岸风花=Fuuka Yamagishi
山岸=Yamagishi
风花=Fuuka
埃癸斯=Aigis
虎狼丸=Koromaru
天田乾=Ken Amada
天田=Amada
荒垣真次郎=Shinjiro Aragaki
荒垣前辈=Aragaki-senpai
荒垣=Aragaki
真次郎=Shinjiro
几月修司=Shuji Ikutsuki
修司=Shuji
望月绫时=Ryoji Mochizuki
望月=Mochizuki
绫时=Ryoji
斯特雷加=Strega
史特雷加=Strega
榊贵隆也=Takaya Sakaki
榊贵=Sakaki
隆也=Takaya
白户阵=Jin Shirato
白户=Shirato
吉野千鸟=Chidori Yoshino
吉野=Yoshino
千鸟=Chidori

----------------------------
P5X/P5 
----------------------------
鹿野莓=Ichigo Shikano
鹿野=Shikano
长尾 爱歌=Manaka Nagao
长尾爱歌=Manaka Nagao
长尾=Nagao
爱歌=Manaka
雨宫莲=Ren Amamiya
雨宫=Amamiya
摩尔加纳=Morgana
坂本龙司=Ryuji Sakamoto
坂本=Sakamoto
龙司=Ryuji
鸭志田=Kamoshida
高卷杏=Ann Takamaki
高卷=Takamaki
喜多川祐介=Yusuke Kitagawa
喜多川=Kitagawa
祐介=Yusuke
新岛真=Makoto Niijima
新岛=Niijima
佐仓双叶=Futaba Sakura
佐仓=Sakura
双叶=Futaba
奥村春=Haru Okumura
奥村=Okumura
明智吾郎=Goro Akechi
明智=Akechi
吾郎=Goro
李瑶铃=Yaoling Li
瑶铃=Yaoling
西森阳菜=Haruna Nishimori
西森=Nishimori
阳菜=Haruna
路菲尔=Lufel
多祢村 理子=Riko Tanemura
多祢村理子=Riko Tanemura
多祢村学姐=Tanemura-senpai
多祢村同学=Tanemura-san
多祢村=Tanemura
理子学姐=Riko-senpai
理子前辈=Riko-senpai
理子小姐=Riko-san
理子=Riko
新井素羽=Motoha Arai
素羽=Motoha
新井=Arai
加纳=Kanou
加纳骏=Shun Kanou
小骏=Shun
骏=Shun
坂井绫香=Ayaka Sakai
绫香小姐=Ayaka-san 
坂井=Sakai
绫香=Ayaka
神山岭央=Leo Kamiyama
神山=Kamiyama
岭央=Leo
富山佳代=Kayo Tomiyama
富山=Tomiyama
佳代=Kayo
野毛朋子=Tomoko Noge
野毛=Noge
朋子=Tomoko
黑谷清=Kiyoshi Kurotani
黑谷=Kurotani
藤川雪实=Yukimi Fujikawa
藤川=Fujikawa
雪实=Yukimi
白鸟诚司=Seiji Shiratori
白鸟=Shiratori
诚司=Seiji
须见俊也=Toshiya Sumi
须见=Sumi
俊也=Toshiya
琴音·蒙塔涅=Kotone Montagne
琴音=Kotone
蒙塔涅=Montagne
佐原海夕=Miyu Sahara
佐原=Sahara
海夕=Miyu
伊戈尔=Igor
伊格尔=Igor 
梅洛普=Merope
木内雄之=Takeyuki Kiuchi
木内的=Kiuchi's
木内=Kiuchi
雄之=Takeyuki
岩井宗久=Munehisa Iwai
岩井=Iwai
宗久=Munehisa
阿七=Shichi-kun
池波学长=Ikenami-senpai
池波 星辉=Ikenami Shoki 
池波星辉=Ikenami Shoki 
池波同学=Ikenami-kun
星辉=Shoki
池波=Ikenami
平野 亚兰=Aran Hirano
平野亚兰=Aran Hirano
平野同学=Hirano-san
平野=Hirano
亚兰=Aran
道玄坂 琉七=Runa Dogenzaka
道玄坂琉七=Runa Dogenzaka
道玄坂=Dogenzaka
琉七=Runa
芳泽霞=Kasumi Yoshizawa
芳泽=Yoshizawa
琴音 蒙塔涅·漫舞=Kotone Montagne
宫下美波=Minami Miyashita
宫下=Miyashita
美波=Minami
北里基良=Kira Kitazato
北里=Kitazato
基良=Kira
芦谷真咲=Masaki Ashiya
芦谷=Ashiya
真咲=Masaki
桥本 麻由美=Mayumi Hashimoto
桥本麻由美=Mayumi Hashimoto
桥本=Hashimoto
麻由美=Mayumi
夏川 澪=Mio Natsukawa
夏川澪=Mio Natsukawa
夏川=Natsukawa
玛奇姆=Marthym
安德森=Anderson
下津名 高美=Takami Shimotsuna
下津名高美小姐=Takami Shimotsuna-san
下津名高美=Takami Shimotsuna
下津名小姐=Shimotsuna-san
小下津名=Shimotsuna-chan
下津名大人=Shimotsuna-sama
阴影下津名=Shadow Shimotsuna
下津名的宫殿=Shimotsuna's Palace
下津名的秘宝=Shimotsuna's Treasure
下津名=Shimotsuna
高美小姐=Takami-san
高美=Takami
逢坂 大地=Daichi Osaka
逢坂大地=Daichi Osaka
逢坂=Osaka
大地前辈=Daichi-senpai
大地=Daichi
KOKORO大哥=KOKORO BRO
KOKORO先生=KOKORO-san
KOKORO=KOKORO
谢迪姆=Shedim
梨本成瑠海=Narumi Nashimoto
梨本=Nashimoto
成瑠海=Narumi
成瑠瑠=Naruru
片山久未=Kumi Katayama
片山=Katayama
久未=Kumi
松方结=Musubi Matsukata
松方=Matsukata
小出日和=Hiyori Koide
小出=Koide
日和=Hiyori
白井纱纪=Saki Shirai
白井=Shirai
纱纪=Saki
-------------------
Locations
------------------
己刮=Kokatsu
己刮学园=Kokatsu Academy
都立轨雅高校=Metropolitan Kiga High School
轨雅高校=Kiga High School
轨雅=Kiga
严户台=Iwatodai
港湾人工岛=Port Island
天鵝絨房向=Velvet Room
安全屋=Safe Room
协同者=Confidant
异世界=Metaverse
印象空间=Mementos
卢布朗咖啡屋=Café Leblanc
卢布朗=Leblanc
生存游戏专卖店=Untouchable
武见诊所=Takemi Clinic
超市=Supermarket
表参道=Omotesando
西参道=Nishisendo
地下商场=Underground Mall
联络桥=Skyway
中央大街=Central Street
十字路口=Intersection
站前广场=Station Square
学校正门=School Entrance
下北泽车站=Shimokitazawa Station
学校天台=School Rooftop
学校三楼=School 3rd Floor
学校二楼=School 2nd Floor
学校一楼=School 1st Floor
荻洼=Ogikubo
原宿=Harajuku
神保町=Jimbōchō
水道桥=Suidōbashi
神田=Kanda
怪盗培养=Velvet Room
杂司谷=Zoshigaya
的楼梯=Staircases
地铁站=Subway Station
电话亭=Telephone booths
四轩茶屋=Yongen-Jaya
卧室=Bedrooms
二手杂货店=Occasion Store
扭蛋=Gachapon
衣柜=Wardrobe
工作台=Workshop
种植=Garden
烹饪=Kitchen
宫殿=Palace
月光馆学园=Gekkoukan High School
月光馆学生宿舍=Iwatodai Dorm
岩户台车站=Iwatodai Station
岩户台=Iwatodai
桐叶购物中心=Paulownia Mall 
阏凶梦之扉=Nightmare's Gateway

----------------------------
Wonder Persona Names
----------------------------
马卡布=Macabre
婆苏吉=Vasuki
吹号者=Trumpeter
佐比持神=Sahimochi-no-kami
藏王权现=Zaou-Gongen
亚诺希克=Jánošík
木灵=Kodama
皮克希=Pixie
飞天=Apsaras
奇魂=Kushi Mitama
和魂=Nigi Mitama
狮爷=Shiisaa
杰克灯笼=Jack-o'-lantern
阿珈席翁=Agathion
莫克伊=Mokoi
双角兽=Bicorn
花魄=Hua Po
曼陀罗=Mandrake
克鲁波克鲁=Koropokguru
凯尔派=Kelpie
软泥怪=Ooze
安德拉斯=Andras
幸魂=Saki Mitama
木叶天狗=Koppa Tengu
真神=Makami
犬神=Inugami
山灵=Sudama
义经=Yoshitsune
默基瑟德=Melchizedek
毘沙门天=Bishamonten
诺伦=Norn
毗湿奴=Vishnu 
死灵之书=Necronomicon
湿婆=Shiva
年兽=Nian
斯拉欧加=Sraosha
齐格飞=Siegfried
圣德芬=Sandalphon
邪恶霜精=Black Frost
玄武=Genbu
比利士=Berith
克鲁波克鲁=Koropokguru
安德拉斯=Andras
莲南希=Leanan Sidhe
木叶天狗=Koppa Tengu
男梦魔=Incubus
库夫林=Cu Chulainn
切尔诺伯格=Chernobog
希路奇=Silky
双角兽=Bicorn
凯尔派=Kelpie
幸魂=Saki Mitama
莫克伊=Mokoi
花魄=Hua Po
黑软泥怪=Black Ooze
软泥怪=Slime
埃力格=Eligor
杰克霜精=Jack Frost
母夜叉=Yaksini
奴延=Nue
飞天=Apsaras
木灵=Kodama
阴摩罗鬼=Onmoraki
一本踏鞴=Ippon-Datara
犬神=Inugami
奇魂=Kushi Mitama
真神=Makami
狮爷=Shiisaa
欧若博司=Orobas
猫又=Nekomata
山灵=Sudama
朱雀=Suzaku
和魂=Nigi Mitama
大天使=Archangel
式王子=Shiki-Ouji
拉弥亚=Lamia
瑟坦特=Setanta
权天使=Principality
天钿女=Ame-no-Uzume
猫将军=Neko Shogun
欧特鲁斯=Orthrus
持国天王=Jikokuten
睡魔=Sandman
水鬼=Sui-Ki
罗刹=Rakshasa
那伽王=Raja Naga
那伽=Naga
佛劳洛斯=Flauros
伊西斯=Isis
阿努比斯=Anubis
独角兽=Unicorn
地狱天使=Hell Biker
苍白骑士=Pale Rider
白骑士=White Rider
莉莉姆=Lilim
拉刻西斯=Lachesis
荒霸吐=Arahabaki
贝尔芬格=Belphegor
阿特罗波斯=Atropos
诃梨帝母=Hariti
单卡拉比=Decarabia
密特拉=Mitra
菊理媛=Kikuri-Hime
大僧正=Daisoujou
大国主=Okuninushi
白虎=Byakko
那耳喀索斯=Narcissus
妙音天女=Sarasvati
欧赛=Ose
妖精女王=Queen Mab
广目天王=Koumokuten
荷鲁斯=Horus
红骑士=Red Rider
能天使=Power
虹蛇=Yurlungur
女武神=Valkyrie
斯卡哈=Scathach
兰达=Rangda
赛特=Seth
缇坦妮雅=Titania
巴风特=Baphomet
葛内舍=Ganesha
丝卡蒂=Skadi
帕尔瓦蒂=Parvati
摩洛=Moloch
迦楼罗=Garuda
八咫乌=Yatagarasu
托尔=Thor
八岐大蛇=Yamata-no-Orochi
贝利亚=Belial
主天使=Dominion
吉祥天女=Lakshmi
青龙=Seiryu
黄龙=Kohryu
爱丽丝=Alice
背背鬼=Obariyon
阿珈席翁=Agathion
曼陀罗=Mandrake
杰克灯笼=Jack-o'-Lantern
女梦魔=Succubus
霜精之王=King Frost
风鬼=Fuu-Ki
斗牛士=Matador
克洛托=Clotho
凤凰=Phoenix
金鬼=Kin-Ki
安祖=Anzu
增长天王=Zouchouten
荒魂=Ara Mitama
佳塔由=Jatayu
天蛾人=Mothman
托特=Thoth
迦温=Kaiwan
米特拉斯=Mithras
百臂巨人=Hecatoncheires
基力梅卡拉=Girimehkala
鸠盘荼=Kumbhanda
奇稻田姬=Kushinada-Hime
帕祖祖=Pazuzu
巴古斯=Bugs
荼吉尼=Dakini
巴隆=Barong
斯尔特=Surt
克鲁贝洛斯=Cerberus
黑骑士=Black Rider
羽蛇神=Quetzalcoatl
狄俄尼索斯=Dionysus
奈比洛斯=Nebiros
奥伯隆=Oberon
天使=Angel

----------------------------
Character Persona Names
----------------------------

----------------------------
P3R
----------------------------
俄耳甫斯=Orpheus
伊娥=Io
波吕克斯=Polydeuces
----------------------------
P5X/P5R
----------------------------
敏特=Minthe
忒尔克西厄珀亚=Thelxiepeia
庇堤斯=Pitys
金诺=Ghino
欧忒耳珀=Euterpe
千代女=Chiyome
塔利亚=Thalia
乌剌尼亚=Urania
奥拉=Aura
琼安=Johanna
辛德瑞拉=Cendrillon
米莱迪=Milady
五右卫门=Goemon 
罗宾汉=Robin Hood 
哈耳皮厄=Harpyia
艾普苏黛丝=Apseudes
安珀罗丝=Ampelos
阿玛耳忒亚=Amalthea
亚森=Arsène
佐罗=Zorro
基德船长=Captain Kidd
卡门=Carmen
孟婆=Meng Po
戴埃拉=Daeira
罗布罗伊=Rob Roy
阿尔维达=Awilda
芒德兰=Mandrin
厄律忒亚=Erytheia
克丽奥多拉=Cleodora
普罗西姆纳=Prosymna
绪刻=Skye
斯堤克斯=Styx
琉科忒亚=Leucothea
戈尔究拉=Gorgyra
忒耳普西科瑞=Terpsichore
涅墨耳忒斯=Nemertes


------------
Generic
------------
套装效果=Kit effect
防御力=DEF
攻击力=ATK
生命值=HP
精力值=SP
速度=SPD
暴击率=Critical Rate
暴击效果=Critical Damage
精力回复=SP Regen
战斗技巧=Combat Skills
穿透=PEN
伤害加成=Damage Bonus
效果抵抗=Effect RES
效果命中=Effect Hit Rate
治疗效果=Healing Bonus
叠层=Stacks
人格面具=Persona
燃烧=Burn
单伤=Single-Target
群伤=Multi-Target
绝对审判=Absolute Judgement
正理之令=Decree of Righteousness
大义者裁决=Rules of the Righteous
怪盗团=Phantom Thieves
向日葵=Sunflower
空空如也=Empty
展示柜=Display case
是否要=Do you want to 
免费=Free
女神异闻录：夜幕魅影=Persona 5: The Phantom X
大富翁=Tycoon
现金=Money
